PetoAD_Amicalola	AMC
PetoB_Amicalola	AMC
PetoAE_Amicalola	AMC
PetoC_Amicalola	AMC
PkusAI_Conasauga	CON
PkusZ_Conasauga	CON
PkusAK_Conasauga	CON
PkusAL_Conasauga	CON
PkusAT_Coosawattee	COO
PetoS_Etowah	ETO
PetoAB_Etowah	ETO
PetoAH_Etowah	ETO
PkusBF_HollyCreek	HOL
PkusBC_HollyCreek	HOL
PkusBE_HollyCreek	HOL
PkusBD_HollyCreek	HOL
PetoAK_LongSwamp	LON
PetoAL_LongSwamp	LON
PetoW_LongSwamp	LON
PetoAM_LongSwamp	LON
PkusAQ_TalkingRock	COO
PetoN_TalonaCreek	COO
